%%%%%%%%%%%%%%%%%%%%%%
%    $$              %
%   $  $             %
%    $$              %
%       $  %         %
%      $$$           %
%     $$ $$          %
%      $$$           %
%       $           $%
%                  $ %
%%%%%%%%%%%%%%%%%%%%%%
