%%%%%%%%%%%%%%%%%%%%%%
%                    %
%                    %
%                    %
%                    %
%                    %
%                    %
%                    %
%                    %
%                    %
%%%%%%%%%%%%%%%%%%%%%%
