%%%%%%%%%%%%%%%%%%%%%%
%                    %
%                    %
%                    %
%                    %
%                    %
%                    %
%                    %
%                   $%
%  $$$$$$$$$$$$$$$$$ %
%%%%%%%%%%%%%%%%%%%%%%