%%%%%%%%%%%%%%%%%%%%%%%%%
%   % $$%$$$% $$% $$%   %
%$$$ $$ $$$$$$$$$ $ $$$$%
% $ %$$$%$$$%$$$%$$$% $ %
%$$$ $$ $$$$$$$$$ $ $$$$%
%$$ % $$%$$$% $$% $$%$$$%
%$$$ $$ $$$$$$$$$ $ $$$$%
% $$%$$$%$$$%$$$%$$$% $ %
%$$$ $$ $$$$$$$$$ $ $$$$%
%$$ % $$%$$$% $$% $$%$$$%
%$$$ $$ $$$$$$$$$ $ $$$$%
% $ %$$$%$$$%$$$%$$$%$$ %
%$$$ $$ $$$$$$$$$ $ $$$$%
%$$ % $$%$$$% $$% $$%$$$%
%$$$ $$ $$$$$$$$$ $ $$$$%
%   %$$$%$$$%$$$%$$$%   %
%%%%%%%%%%%%%%%%%%%%%%%%%