%%%%%%%%%%%%%%%
%   %$$$$$%   %
%$$$%$$$$$%$$$%
%$$$$$$$$$$$$$%
%%$ $$%$%$$ $%%
%$$$%$$$$$%$$$%
%$$$$$$$$$$$$$%
%%$ $$%$%$$ $%%
%%$ $$%$%$$ $%%
%$$$$$$$$$$$$$%
%$$$%$$$$$%$$$%
%%$ $$%$%$$ $%%
%$$$$$$$$$$$$$%
%$$$%$$$$$%$$$%
%   %$$$$$%   %
%%%%%%%%%%%%%%%
