%%%%%%%%%%%%%%%%%%%%%%%
%$$ $$ $$ $$$ $$ $$ $$%
%      $       $      %
%$$$$$$         $$$$$$%
%                     %
% $  $           $  $ %
%      $       $      %
%$$$$$$         $$$$$$%
%      $$$$$$$$$      %
% $ $ $         $ $ $ %
%        $ $ $        %
%$$$$$$         $$$$$$%
%          $          %
%%%%%%%%%%%%%%%%%%%%%%%
