%%%%%%%%%%%%%%%%%%%%%%
%E                $  %
%          $$$$$$$$  %
%                 $  %
%     $    $      $  %
%     $           $  %
%     $              %
%   $$$              %
%           $$$$$$$  %
%     $              %
%%%%%%%%%%%%%%%%%%%%%%
