%%%%%%%%%%%%%%%%%%%%%%%
%$$ $$ $$ $$$ $$ $$ $$%
%  E   $       $      %
%$$$$$$         $$$$$$%
%                     %
% $  $           $  $ %
%      $       $      %
%$$$$$$         $$$$$$%
%      $$$$$$$$$      %
% $ $ $         $ $ $ %
%        $ $ $        %
%$$$$$$         $$$$$$%
%          $         B%
%%%%%%%%%%%%%%%%%%%%%%%
