%%%%%%%%%%%%%%%%%%%%%%%
%$$ $$ $$ $$$ $$ $$ $$%
%      $       $      %
%$$$$$$         $$$$$$%
%                     %
% $  $     R     $  $ %
%      $       $      %
%$$$$$$         $$$$$$%
%      $$$$$$$$$      %
% $ $ $         $ $ $ %
%        $ $ $     V  %
%$$$$$$         $$$$$$%
%          $         B%
%%%%%%%%%%%%%%%%%%%%%%%
